[level]
tileset = lab
map =   ^^ff..ff^^
        ^^ff..ff^^
        f^ff.fff^f
        ffffffffff
        f^fff.ff^f
        ^^ff..ff^^
        ^^ff..ff^^